1111111111111111111111111111111
1EX0X0X0X00X0X0CX0X0X0CX0X0X011
1EX0X0X0X0X0X0XC0X0X0XC0X0X0X11
10X0XX0X0X0X0X0CX0X0X0CX0X0X011
1X0X0X0X0X0X0X0CX0X0X0CX0X0X011
1X0X0X0X0X0X0X0CX0X0X0CX0X0X011
1X0X0X0X0X0X0X0CX0X0X0CX0X0X011
1X0X0X0X0X0X00XCX0X0X0CX0X0X011
1X0X0X0X0X0X0X0CX0XX0XC0X0X0X11
1111110X101X101X0X10X10X0X0X011
1P00010X0C00C00000000000X000011
1111111111111111111111111111111