1111111111111
1EE10000E00C1
1EEEE11111101
1PEE110000EE1
1111111111111