111111111111111111111111111111111111111111111111111
1E00000X0000000C00000XC0000000000100000X0000000C111
1C1001010010000010100100000001010110010100100000111
101001001010101000100100000001010110010010101010111
1P00000X0C00C00000000000X0000000C000000X0C00C000111
111111111111111111111111111111111111111111111111111