1111111111111111111111111111111111
1E00000X0000000C00000XC00000000001
1C10010100100000101001000000010101
1010010010101010001001000000010101
1P00000X0C00C00000000000X0000000C1
1111111111111111111111111111111111